17:1 19:1 21:1 20:1 21:1 20:1 21:1 20:1 17:1 0:0 0:0 0:0 0:0 0:0 0:0 0:0 0:0 0:0 0:0 0:0 19:1 6:1 6:1 6:1 6:1 6:1 6:1 6:1 6:1 6:1
17:1 19:1 5:1 4:1 5:1 4:1 5:1 4:1 17:1 0:0 0:0 0:0 0:0 0:0 0:0 0:0 0:0 0:0 0:0 0:0 19:1 1:1 2:1 3:1 1:1 2:1 3:1 1:1 2:1 3:1
17:1 5:1 2:1 2:1 2:1 2:1 2:1 2:1 4:1 0:0 0:0 0:0 0:0 0:0 0:0 0:0 0:0 0:0 0:0 0:0 19:1 17:1 18:1 19:1 17:1 18:1 19:1 17:1 18:1 19:1
17:1 0:0 0:0 0:0 0:0 0:0 0:0 0:0 0:0 0:0 0:0 0:0 0:0 0:0 0:0 0:0 0:0 0:0 0:0 0:0 19:1 33:1 34:1 35:1 33:1 34:1 35:1 33:1 34:1 35:1
4:1 0:0 0:0 0:0 0:0 0:0 0:0 0:0 0:0 0:0 0:0 0:0 0:0 0:0 0:0 0:0 0:0 0:0 0:0 0:0 5:1 2:1 2:1 2:1 2:1 2:1 2:1 2:1 2:1 2:1
0:0 0:0 0:0 0:0 0:0 0:0 0:0 0:0 0:0 0:0 0:0 0:0 0:0 0:0 0:0 0:0 0:0 0:0 0:0 0:0 0:0 0:0 0:0 0:0 0:0 0:0 0:0 0:0 0:0 0:0
0:0 0:0 0:0 0:0 0:0 0:0 0:0 0:0 0:0 0:0 0:0 0:0 0:0 0:0 0:0 0:0 0:0 0:0 0:0 0:0 0:0 0:0 0:0 0:0 0:0 0:0 0:0 0:0 0:0 0:0
0:0 0:0 0:0 0:0 0:0 0:0 0:0 0:0 0:0 0:0 0:0 0:0 0:0 0:0 0:0 0:0 0:0 0:0 0:0 0:0 0:0 0:0 0:0 0:0 0:0 0:0 0:0 0:0 0:0 0:0
0:0 0:0 0:0 0:0 0:0 0:0 0:0 0:0 0:0 0:0 0:0 0:0 0:0 0:0 0:0 0:0 0:0 0:0 0:0 0:0 0:0 0:0 0:0 0:0 0:0 0:0 0:0 0:0 0:0 0:0
0:0 0:0 0:0 0:0 0:0 0:0 0:0 0:0 0:0 0:0 0:0 0:0 0:0 0:0 0:0 0:0 0:0 0:0 0:0 0:0 0:0 0:0 0:0 0:0 0:0 0:0 0:0 0:0 0:0 0:0
20:1 0:0 0:0 0:0 0:0 0:0 0:0 0:0 0:0 0:0 0:0 0:0 0:0 0:0 0:0 0:0 0:0 0:0 0:0 0:0 21:1 34:1 34:1 34:1 34:1 34:1 34:1 34:1 34:1 34:1
17:1 0:0 0:0 0:0 0:0 0:0 0:0 0:0 0:0 0:0 0:0 0:0 0:0 0:0 0:0 0:0 0:0 0:0 0:0 0:0 19:1 1:1 2:1 3:1 1:1 2:1 3:1 1:1 2:1 3:1
17:1 21:1 34:1 34:1 34:1 34:1 34:1 34:1 20:1 0:0 0:0 0:0 0:0 0:0 0:0 0:0 0:0 0:0 0:0 0:0 19:1 17:1 18:1 19:1 17:1 18:1 19:1 17:1 18:1 19:1
17:1 19:1 21:1 20:1 21:1 20:1 21:1 20:1 17:1 0:0 0:0 0:0 0:0 0:0 0:0 0:0 0:0 0:0 0:0 0:0 19:1 33:1 34:1 35:1 33:1 34:1 35:1 33:1 34:1 35:1
17:1 19:1 5:1 4:1 5:1 4:1 5:1 4:1 17:1 0:0 0:0 0:0 0:0 0:0 0:0 0:0 0:0 0:0 0:0 0:0 19:1 6:1 6:1 6:1 6:1 6:1 6:1 6:1 6:1 6:1
