18:1 18:1 18:1 18:1 18:1 18:1 18:1 18:1 18:1 18:1 18:1 18:1 18:1 18:1 18:1 18:1 18:1 18:1 18:1 18:1 18:1 18:1 18:1 18:1 18:1 18:1 18:1 18:1 18:1 18:1
18:1 18:1 18:1 0:0 18:1 18:1 18:1 0:0 18:1 18:1 18:1 0:0 18:1 18:1 18:1 0:0 18:1 18:1 18:1 0:0 18:1 18:1 18:1 0:0 18:1 18:1 18:1 0:0 18:1 18:1
18:1 18:1 0:0 0:0 0:0 18:1 0:0 0:0 0:0 18:1 0:0 0:0 0:0 18:1 0:0 0:0 0:0 18:1 0:0 0:0 0:0 18:1 0:0 0:0 0:0 18:1 0:0 0:0 0:0 18:1
18:1 0:0 0:0 0:0 0:0 0:0 0:0 0:0 0:0 0:0 0:0 0:0 0:0 0:0 0:0 0:0 0:0 0:0 0:0 0:0 0:0 0:0 0:0 0:0 0:0 0:0 0:0 0:0 0:0 18:1
0:0 0:0 0:0 0:0 0:0 0:0 0:0 0:0 0:0 0:0 0:0 0:0 0:0 0:0 0:0 0:0 0:0 0:0 0:0 0:0 0:0 0:0 0:0 0:0 0:0 0:0 0:0 0:0 0:0 18:1
0:0 0:0 0:0 0:0 0:0 0:0 0:0 0:0 0:0 0:0 0:0 0:0 0:0 0:0 0:0 0:0 0:0 0:0 0:0 0:0 0:0 0:0 0:0 0:0 0:0 0:0 0:0 0:0 0:0 18:1
0:0 0:0 0:0 0:0 0:0 0:0 0:0 0:0 0:0 0:0 0:0 0:0 0:0 0:0 0:0 0:0 0:0 0:0 0:0 0:0 0:0 0:0 0:0 0:0 0:0 0:0 0:0 0:0 0:0 18:1
0:0 0:0 0:0 0:0 0:0 0:0 0:0 0:0 0:0 0:0 0:0 0:0 0:0 0:0 0:0 0:0 0:0 0:0 0:0 0:0 0:0 0:0 0:0 0:0 0:0 0:0 0:0 0:0 0:0 18:1
0:0 0:0 0:0 0:0 0:0 0:0 0:0 0:0 0:0 0:0 0:0 0:0 0:0 0:0 0:0 0:0 0:0 0:0 0:0 0:0 0:0 0:0 0:0 0:0 0:0 0:0 0:0 0:0 0:0 18:1
0:0 0:0 0:0 0:0 0:0 0:0 0:0 0:0 0:0 0:0 0:0 0:0 0:0 0:0 0:0 0:0 0:0 0:0 0:0 0:0 0:0 0:0 0:0 0:0 0:0 0:0 0:0 0:0 0:0 18:1
0:0 0:0 0:0 0:0 0:0 0:0 0:0 0:0 0:0 0:0 0:0 0:0 0:0 0:0 0:0 0:0 0:0 0:0 0:0 0:0 0:0 0:0 0:0 0:0 0:0 0:0 0:0 0:0 0:0 18:1
18:1 0:0 0:0 0:0 0:0 0:0 0:0 0:0 0:0 0:0 0:0 0:0 0:0 0:0 0:0 0:0 0:0 0:0 0:0 0:0 0:0 0:0 0:0 0:0 0:0 0:0 0:0 0:0 0:0 18:1
18:1 18:1 0:0 0:0 0:0 18:1 0:0 0:0 0:0 18:1 0:0 0:0 0:0 18:1 0:0 0:0 0:0 18:1 0:0 0:0 0:0 18:1 0:0 0:0 0:0 18:1 0:0 0:0 0:0 18:1
18:1 18:1 18:1 0:0 18:1 18:1 18:1 0:0 18:1 18:1 18:1 0:0 18:1 18:1 18:1 0:0 18:1 18:1 18:1 0:0 18:1 18:1 18:1 0:0 18:1 18:1 18:1 0:0 18:1 18:1
18:1 18:1 18:1 18:1 18:1 18:1 18:1 18:1 18:1 18:1 18:1 18:1 18:1 18:1 18:1 18:1 18:1 18:1 18:1 18:1 18:1 18:1 18:1 18:1 18:1 18:1 18:1 18:1 18:1 18:1
